bbbbbbbbbbbbbbbbbbbbbbbbbbbbbb
bd               d b        db
b          b       b         b
b      c   b       b         b
b                  b         b
b                  b         b
b bb     bbbbbbbb  b         b
b b             b  b      b  b
b            u  b  b      b  b
bpbbbbbbbbbbbb  b  b     ub  b
b               b  b     bb  b
b               b  b     bb  b
b       b   bb  b  b   b  b  b
b       b   rb  b      b  b  b
b    b       b  b    b    b  b
be   b bb    bbbb    b    b sb
bbbbbbbbbbbbbbbbbbbbbbbbbbbbbb
