bbbbbbbbbbbbbbbbbbbbbbbbbbbbbb
b     d                l     b
b                            b
b                            b
b                            b
b                            b
b                            b
b                            b
b            bbbb            b
b                            b
b                            b
b                            b
b                            b
b                            b
b                            b
be    r                u    sb
bbbbbbbbbbbbbbbbbbbbbbbbbbbbbb
